40
60
13 13 13 13 13 13 13 13 13 13 13 13 13 13 13 13 13 13 13 13 13 13 13 13 13 13 13 13 13 13 13 13 13 13 13 13 13 13 13 13
13 9  11 11 8  13 9  11 11 11 11 11 13 11 11 11 11 11 11 13 9  0  1  2  6  14 7  8  13 14 5  3  0  0  0  6  14 7  7  13
13 5  2  3  8  13 9  0  0  0  0  8  13 9  0  0  0  0  0  0  0  0  0  1  2  6  14 7  8  13 14 5  3  0  0  0  6  14 7  13
13 5  2  3  8  13 9  0  0  0  0  8  13 9  0  0  0  0  0  0  0  0  0  1  2  6  14 7  8  13 14 5  3  0  0  0  6  14 7  13
13 5  2  3  8  13 9  0  0  0  0  8  13 9  0  0  0  0  0  0  0  0  0  1  2  6  14 7  8  13 14 5  3  0  0  0  6  14 7  13
13 5  2  3  8  13 9  0  0  0  0  8  13 9  0  0  0  0  0  0  0  0  0  1  2  6  14 0  0  0  0  0  0  0  0  0  6  14 7  13
13 5  2  3  8  13 9  0  0  0  0  8  13 9  0  0  0  0  0  0  0  0  0  1  2  6  14 7  0  0  0  0  3  0  0  0  6  14 7  13
13 5  2  3  8  13 9  0  0  0  0  8  13 9  0  0  0  0  0  0  0  0  0  1  2  6  14 7  0  0  0  0  3  0  0  0  6  14 7  13
13 5  2  3  8  13 9  0  0  0  0  8  13 9  0  0  0  0  0  0  0  0  0  1  2  6  14 7  8  13 14 5  3  0  0  0  6  14 7  13
13 5  2  3  8  13 9  0  0  0  0  8  13 9  0  0  0  0  0  0  0  0  0  1  2  6  14 7  8  13 14 5  3  0  0  0  6  14 7  13
13 5  2  3  8  13 9  0  0  0  0  8  13 9  0  0  0  0  0  0  0  0  0  1  2  6  14 7  0  0  0  0  3  0  0  0  6  14 7  13
13 5  2  3  8  13 9  0  0  0  0  8  13 9  0  0  0  0  0  0  0  0  0  1  2  6  14 7  0  0  0  0  3  0  0  0  6  14 7  13
13 5  2  3  8  13 9  0  0  0  0  8  13 9  0  0  0  0  0  0  0  0  0  1  2  6  14 7  8  13 14 5  3  0  0  0  6  14 7  13
13 5  2  3  8  13 9  0  0  0  0  8  13 9  0  0  0  0  0  0  0  0  0  1  2  6  14 0  0  0  0  0  0  0  0  0  6  14 7  13
13 5  2  3  8  13 9  0  0  0  0  8  13 9  0  0  0  0  0  0  0  0  0  1  2  6  14 7  0  0  0  0  3  0  0  0  6  14 7  13
13 5  2  3  8  13 9  0  0  0  0  8  13 9  0  0  0  0  0  0  0  0  0  1  2  6  14 7  0  0  0  0  3  0  0  0  6  14 7  13
13 5  2  3  8  13 9  0  0  0  0  8  13 9  0  0  0  0  0  0  0  0  0  1  2  6  14 7  8  13 14 5  3  0  0  0  6  14 7  13
13 5  2  3  8  13 9  0  0  0  0  8  13 9  0  0  0  0  0  0  0  0  0  1  2  6  14 7  8  13 14 5  3  0  0  0  6  14 7  13
13 5  2  3  8  13 9  0  0  0  0  8  13 9  0  0  0  0  0  0  0  0  0  1  2  6  14 7  0  0  0  0  3  0  0  0  6  14 7  13
13 5  2  3  8  13 9  0  0  0  0  8  13 9  0  0  0  0  0  0  0  0  0  1  2  6  14 7  0  0  0  0  3  0  0  0  6  14 7  13
13 5  2  3  8  13 9  0  0  0  0  8  13 9  0  0  0  0  0  0  0  0  0  1  2  6  14 7  8  13 14 5  3  0  0  0  6  14 7  13
13 5  2  3  8  13 9  0  0  0  0  8  13 9  0  0  0  0  0  0  0  0  0  1  2  6  14 0  0  0  0  0  0  0  0  0  6  14 7  13
13 5  2  3  8  13 9  0  0  0  0  8  13 9  0  0  0  0  0  0  0  0  0  1  2  6  14 7  0  0  0  0  3  0  0  0  6  14 7  13
13 5  2  3  8  13 9  0  0  0  0  8  13 9  0  0  0  0  0  0  0  0  0  1  2  6  14 7  0  0  0  0  3  0  0  0  6  14 7  13
13 5  2  3  8  13 9  0  0  0  0  8  13 9  0  0  0  0  0  0  0  0  0  1  2  6  14 7  8  13 14 5  3  0  0  0  6  14 7  13
13 5  2  3  8  13 9  0  0  0  0  8  13 9  0  0  0  0  0  0  0  0  0  1  2  6  14 7  8  13 14 5  3  0  0  0  6  14 7  13
13 5  2  3  8  13 9  0  0  0  0  8  13 9  0  0  0  0  0  0  0  0  0  1  2  6  14 7  0  0  0  0  3  0  0  0  6  14 7  13
13 5  2  3  8  13 9  0  0  0  0  8  13 9  0  0  0  0  0  0  0  0  0  1  2  6  14 7  0  0  0  0  3  0  0  0  6  14 7  13
13 5  2  3  8  13 9  0  0  0  0  8  13 9  0  0  0  0  0  0  0  0  0  1  2  6  14 7  8  13 14 5  3  0  0  0  6  14 7  13
13 5  2  3  8  13 9  0  0  0  0  8  13 9  0  0  0  0  0  0  0  0  0  1  2  6  14 0  0  0  0  0  0  0  0  0  6  14 7  13
13 5  2  3  8  13 9  0  0  0  0  8  13 9  0  0  0  0  0  0  0  0  0  1  2  6  14 7  0  0  0  0  3  0  0  0  6  14 7  13
13 5  2  3  8  13 9  0  0  0  0  8  13 9  0  0  0  0  0  0  0  0  0  1  2  6  14 7  0  0  0  0  3  0  0  0  6  14 7  13
13 5  2  3  8  13 9  0  0  0  0  8  13 9  0  0  0  0  0  0  0  0  0  1  2  6  14 7  8  13 14 5  3  0  0  0  6  14 7  13
13 5  2  3  8  13 9  0  0  0  0  8  13 9  0  0  0  0  0  0  0  0  0  1  2  6  14 7  8  13 14 5  3  0  0  0  6  14 7  13
13 5  2  3  8  13 9  0  0  0  0  8  13 9  0  0  0  0  0  0  0  0  0  1  2  6  14 7  0  0  0  0  3  0  0  0  6  14 7  13
13 5  2  3  8  13 9  0  0  0  0  8  13 9  0  0  0  0  0  0  0  0  0  1  2  6  14 7  0  0  0  0  3  0  0  0  6  14 7  13
13 5  2  3  8  13 9  0  0  0  0  8  13 9  0  0  0  0  0  0  0  0  0  1  2  6  14 7  8  13 14 5  3  0  0  0  6  14 7  13
13 5  2  3  8  13 9  0  0  0  0  8  13 9  0  0  0  0  0  0  0  0  0  1  2  6  14 7  8  13 14 5  3  0  0  0  6  14 7  13
13 5  2  3  8  13 9  0  0  0  0  8  13 9  0  0  0  0  0  0  0  0  0  1  2  6  14 7  8  13 14 5  3  0  0  0  6  14 7  13
13 5  2  3  8  13 9  0  0  0  0  8  13 9  0  0  0  0  0  0  0  0  0  1  2  6  14 7  8  13 14 5  3  0  0  0  6  14 7  13
13 5  2  3  8  13 9  0  0  0  0  8  13 9  0  0  0  0  0  0  0  0  0  1  2  6  14 0  0  0  0  0  0  0  0  0  6  14 7  13
13 5  2  3  8  13 9  0  0  0  0  8  13 9  0  0  0  0  0  0  0  0  0  1  2  6  14 7  0  0  0  0  3  0  0  0  6  14 7  13
13 5  2  3  8  13 9  0  0  0  0  8  13 9  0  0  0  0  0  0  0  0  0  1  2  6  14 7  0  0  0  0  3  0  0  0  6  14 7  13
13 5  2  3  8  13 9  0  0  0  0  8  13 9  0  0  0  0  0  0  0  0  0  1  2  6  14 7  8  13 14 5  3  0  0  0  6  14 7  13
13 5  2  3  8  13 9  0  0  0  0  8  13 9  0  0  0  0  0  0  0  0  0  1  2  6  14 7  8  13 14 5  3  0  0  0  6  14 7  13
13 5  2  3  8  13 9  0  0  0  0  8  13 9  0  0  0  0  0  0  0  0  0  1  2  6  14 7  0  0  0  0  3  0  0  0  6  14 7  13
13 5  2  3  8  13 9  0  0  0  0  8  13 9  0  0  0  0  0  0  0  0  0  1  2  6  14 7  0  0  0  0  3  0  0  0  6  14 7  13
13 5  2  3  8  13 9  0  0  0  0  8  13 9  0  0  0  0  0  0  0  0  0  1  2  6  14 7  8  13 14 5  3  0  0  0  6  14 7  13
13 5  2  3  8  13 9  0  0  0  0  8  13 9  0  0  0  0  0  0  0  0  0  1  2  6  14 0  0  0  0  0  0  0  0  0  6  14 7  13
13 5  2  3  8  13 9  0  0  0  0  8  13 9  0  0  0  0  0  0  0  0  0  1  2  6  14 7  0  0  0  0  3  0  0  0  6  14 7  13
13 5  2  3  8  13 9  0  0  0  0  8  13 9  0  0  0  0  0  0  0  0  0  1  2  6  14 7  0  0  0  0  3  0  0  0  6  14 7  13
13 5  2  3  8  13 9  0  0  0  0  8  13 9  0  0  0  0  0  0  0  0  0  1  2  6  14 7  8  13 14 5  3  0  0  0  6  14 7  13
13 5  2  3  8  13 9  0  0  0  0  8  13 9  0  0  0  0  0  0  0  0  0  1  2  6  14 7  8  13 14 5  3  0  0  0  6  14 7  13
13 5  2  3  8  13 9  0  0  0  0  8  13 9  0  0  0  0  0  0  0  0  0  1  2  6  14 7  0  0  0  0  3  0  0  0  6  14 7  13
13 5  2  3  8  13 9  0  0  0  0  8  13 9  0  0  0  0  0  0  0  0  0  1  2  6  14 7  0  0  0  0  3  0  0  0  6  14 7  13
13 5  2  3  8  13 9  0  0  0  0  8  13 9  0  0  0  0  0  0  0  0  0  1  2  6  14 7  8  13 14 5  3  0  0  0  6  14 7  13
13 5  2  3  8  13 9  0  0  0  0  8  13 9  0  0  0  0  0  0  0  0  0  1  2  6  14 0  0  0  0  0  0  0  0  0  6  14 7  13
13 5  2  3  8  13 9  0  0  0  0  8  13 9  0  0  0  0  0  0  0  0  0  1  2  6  14 7  0  0  0  0  3  0  0  0  6  14 7  13
13 5  2  3  8  13 9  0  0  0  0  8  13 9  0  0  0  0  0  0  0  0  0  1  2  6  14 7  0  0  0  0  3  0  0  0  6  14 7  13
13 13 13 13 13 13 13 13 13 13 13 13 13 13 13 13 13 13 13 13 13 13 13 13 13 13 13 13 13 13 13 13 13 13 13 13 13 13 13 13